+--+--+--+--+--+--+--+--+--+--+
                  |        |  |
+--+--+  +--+--+  +  +--+  +  +
|     |  |  |     |  |     |  |
+  +  +  +  +  +--+--+  +--+  +
|  |  |  |  |        |     |  |
+  +--+  +  +--+--+  +  +  +  +
|           |     |     |     |
+--+--+  +--+  +  +--+--+--+  +
|     |     |  |  |        |  |
+  +  +  +  +  +  +  +--+  +  +
|  |     |  |  |     |     |  |
+  +--+--+  +  +--+--+  +--+  +
|        |     |  |     |     |
+--+--+  +--+--+  +  +--+--+--+
|           |  |              |
+  +--+--+  +  +--+--+  +--+  +
|        |     |     |  |     |
+--+--+  +  +--+  +  +--+--+--+
|        |        |            
+--+--+--+--+--+--+--+--+--+--+