+--+--+--+--+--+--+--+--+--+--+
                  |           |
+--+--+  +--+--+  +  +--+  +  +
|     |  |  |     |  |     |  |
+  +  +  +  +  +--+--+  +--+  +
|  |  |  |  |        |     |  |
+  +--+--+  +--+--+  +  +  +  +
|           |     |     |     |
+--+--+  +--+  +  +--+--+--+  +
|     |     |  |  |        |  |
+  +  +  +  +  +  +  +--+  +  +
|  |     |  |  |     |        |
+  +--+--+  +  +--+--+  +--+  +
|        |        |     |     |
+--+--+  +--+--+  +  +--+--+--+
|           |  |     |        |
+  +--+--+  +  +--+--+  +--+  +
|        |     |     |  |     |
+--+--+  +  +--+  +  +  +  +--+
|        |        |     |      
+--+--+--+--+--+--+--+--+--+--+